NO ./textures/NO.png
SO ./textures/SO.png
WE ./textures/WE.png
EA ./textures/EA.png

F 010,045,110
C 225,30,100





  111111111111111     
10000000000001            
10000011111111
00001001111111
10000000100001
10000001000001
11111111000001
10000000000011
100000000000001
10000000000001
11111111111111