NO ./textures/NO.png
SO ./textures/SO.png
WE ./textures/WE.png
EA ./textures/EA.png

F 010,045,110
C 225,30,100

                  




 0S00   111111111111111
              
111111111             
10000000000001
100000
00001001
100000001000001
10000001000001
11111111000001
100000000000000000000001
100000000000001
10000000000001
1                        
            
BLAA BLAAA


                                  



cats  cats  cats  cats  cats  cats  cats  










