NO ./textures/NO.png
SO ./textures/SO.png
WE ./textures/WE.png
EA ./textures/EA.png

F 150,200,150
C 225,30,0

1111
110011
1001
111111111111111
100000000000001
100110000000001
100110001000001
100000001000001
111111111000001
100000000000001
00000000000000
100000000000N01
111111111111111