11111111
10000111
10010011
10000001
10000N01
11111111
