NO ./textures/NO.png
SO ./textures/SO.png
WE ./textures/WE.png
EA ./textures/EA.png

F 010,045,110
C 225,30,100

                  




     111111111111111
                
1111111111             
100000000000001
100000000001001
100000001000001
100000001000001
11111111N1000001
100000000000000000000001
100000000000001
10000000000001
1                       
