NO ./textures/NO.png
SO ./textures/SO.png
WE ./textures/WE.png
EA ./textures/EA.png

F 010,045,110
C 225,30,100

  1    
111
1
1111
1N01           
10001
10001 
  1111     





