111111111111111
100000000000001
100000000001001
100000001000001
100000001000001
111111111000001
100000000000001
100000000000001
100000000000N01
111111111111111
