NO ./textures/NO.png
SO ./textures/SO.png
WE ./textures/WE.png
EA ./textures/EA.png

F 220,100,0
C 225,30,0

11111
100011
1000111
10001111
100011111
1000000001
10001111
10S01
11111
